
[][][][][][][][][][][][][][][][][][][][][][][][][][][][][][][][][][][][][][][][][][][][][][][][][][][][]  [][][][][][][][][][][][][][][][][][][][][][][][][][][][][][][][][][][][][][][][][][][][][][]
[][][][]        []  []      []    []  []      []      []      []        []      [][]    []    []      []      []  []  []          []      []  []      []          []    []      []  []  []  []  []  []
[][][]  [][][]        []  [][][]          []      []      []    []  [][]  [][]      []      []  []  []  []  []    []      []  []  [][]  []    [][]  []    [][]  []  []      [][]        []  []      []
[][]        []  []  [][]  [][]  [][]  [][]    [][]    [][]    [][]    []  []    [][][][]  []            []  []  []    [][]  [][][]  []      []        []      []    []  [][]    []  [][]    []  [][][]
[]    []  []    []              [][][]      []      []    []        []      []      []    [][]  []  []  []        []        [][]    []  [][]    [][]  []  []    []          []      []  []          []
[][]    []  [][]    []  [][]  []  []  []  [][]  [][]    []  [][][]  []  []      [][]  []    [][]    []  []  []  []    []  []    []        []  []    []      []    [][]  [][]    [][]        [][][]  []
[]  []  []      [][]  []                []      []  []                [][][][]        [][]    []  []    []    [][]  []  [][]  []    [][]  []      [][][]  []  [][]          []        []  [][]    [][]
[]          [][]      [][][][][]  []  []  [][][]      [][][]  [][]  []  []    []  []    [][]    []  []      []      []          []  []  []    [][]  []            [][]  []    [][]  []  []    []    []
[]  []  []      [][]            [][]            []  []      []              []    [][]        []    []  []  []  []      []  []            []          []  [][]  []    []  []                []    [][]
[][]  []    [][]    []  [][][]  []  [][][]  []  []    []  []    []  []  []    []      []  []    []  []    [][][]    []  [][]  [][][]  [][]  []  [][]  []      [][][]  []    []  []  [][]  [][][]    []
[]    [][]  []  []  []  []          []  [][]      []      [][]    []  []    []    [][]  [][]  []    []  [][][]  []  []        []  []  []          []  []  [][]  []      []  []    []        []    [][]
[][]    []  []  []  []  []  []  []  []    [][][]      []      [][]    [][]    []  []            []      [][]          []  [][]      []  []  [][]    []      []    []  []    []  []  []  []      []  []
[]    []    []  []    [][][]  []    [][]      []  []  []  []  []  []      []    []  [][][][]  [][][]  []      []  []    []      [][]    []      []    [][]    []        []    []    [][][][][]      []
[]  []  []        []    []      []        [][]  [][][]      []      [][]    []                  []        []  [][]  []  []  []  [][][]  []  []    [][]      []  []  []    []    []      []  []  [][][]
[]  []    [][]  []    []    []    [][]  []        []  [][]    [][]      []    []  [][][][]  []    []  [][][]    []  [][]  []      [][]  []    [][]    []  [][]    []    []  []  []  []              []
[]  []  []        []    []  []  [][][]  []  [][]          []  []    [][]    []  [][]      []  []            [][]      []  [][]  []      []  []  []  []        []    []      []    []  []  []  []  [][]
[]      []  []  []    []  []      []      []      []  [][]    [][]      []          []  []      []  []  [][]  []  []  []          []  []        []      [][][]    [][][]  [][][]  []  []    [][]    []
[]  []    []      []  []    [][]    []  []    [][]          []      []    [][]  [][]      [][]        [][]    []    []    [][]  []      []  [][][][]  []      []    []      []    []    []  []    [][]
[]  [][]    [][]  []      []    []      []  []    []  []  []  []  []  []            [][]        []  []    []    []    []  []      []  []        []      []  []    []  []  []    []  []    []  []  [][]
[][]  []  []          [][]  []  []  []    []  []    []          [][]    [][][]  [][]    []  [][]        []  []      []  []  []  []      [][]  []  []  [][]    []  []  []    []  []    []  []        []
[][]      []  []  []  [][]      []    []          []    [][][]  []  []  []  []  []  []  []  []  []  [][]        []  []      []      []  []        []        []        []  [][]    []  []  [][][]  [][]
[]    []    []  []        [][]    [][]  []  []  []  []  []    []                          []        []    []  [][][]  []  []    [][]  []  []  [][]    []  []    [][]  []        [][]  []      []    []
[][][][][]  []    []  []  [][]  []      []    []          []    []  []  [][]  []  [][]  []  [][][]    []  [][]  []    []  []  []                [][]    []    []        []  []        [][]  []    [][]
[]    []    [][]  [][]            []  []    []  []  []  []    []  [][][]    []  [][]                []          []  []          []  []  [][]  []    []    []    []  [][][][]  [][]  []  []    []    []
[]  []  []            [][]  [][]  []    []  []  []  [][]  []        []  []  []        []  [][]  []      []  []  []    []  []  []      []    []    []  []      []  []    []    []    []  []  [][]  [][]
[]  []    []  []  []      []  []    []          []        [][][]  []    []  []  []  []  [][]  [][][]  []  []  [][]  []  []        [][][]  [][]  []        []          []    []  []      []  []      []
[]    []    [][][]    [][]        []    []  []      []  []          []  []    [][][]    []      []            []          []  [][]                  []  [][][]  [][]  [][]        []  []    []  [][][]
[][]  []  [][][]  []      []  []  []  []  []  [][]  [][]    []  []          []  []  []  []  []      []  []  []    []  []      [][]  [][]  []  []  [][]  [][]  []        []  []  []      []          []
[]          []        []  [][]      []    []            [][]  []  []  [][]          []  [][][][]  []    []    [][][][]  []  []          []  [][][]    []        [][]  []      []    []    []  [][]  []
[][]  [][]    []  []    []    []  []  []    []  []  [][]      []    []      [][][]  []      []      [][]  [][]    []            []  []        []    [][][][]  []    []    []    [][][]  []        [][]
[][][]      [][][]    []  []      []    []    []      []  []    []    []  []          []  [][][]  []      []    []  [][]  []  []  []  []  []  []  []  []          [][]  []    [][]          [][]    []
[][][][][]    []  []  []    [][]  [][]      []  []  []  []  []    []    []    []  []        []      []  []    []          []  []  []    [][][]          []  []  []    []  []      []  []  []    []  []
[][][]      []          []  []        [][]                    []    []      []  []    []  []  []  []        []  []  []  []  [][]  [][]    [][][]  []  []    [][]    []      [][]      [][]    []  [][]
[][]  []  []  [][][]  []    [][]  []  []  []  []  []  [][]  []    []  [][]  []    [][]    []      []  []  []      []                    []  []    []  []  []      []  [][]  []    [][]      []      []
[]        []  []          []    [][]      [][]  []  [][]        []      []  []  [][]  []  []  [][][]    []  [][]      [][]  [][][]  []  []      []  []      [][]  []  [][]  []  [][]    []    []  [][]
[][]  []  []    []  [][]  []  [][]  [][]        []  []    [][]      [][]  []    []            []      [][]    []  []    []  []    [][][]    [][]      [][]    []                    []    [][]      []
[]  [][]    []  []  []              []    []  []    [][][]    [][]  []      []      []  []  []  []  []      []  []    []  []  []    []  []  []    [][]    []    [][]  [][]  []  [][]  []    [][]  [][]
[]        []      []    []  []  []  []  []  []    []      []    []    []  []    [][][][]              []  []    []  []        []  []          []    [][]  []  []    [][][]    [][]    []  []        []
[][]  []      [][]    []  []  [][]          [][]  []  []    []      []      [][][]  []  [][]  []  []      [][]  []      []  []      []  [][]  []  []  []        []    []    []      []    []  []  [][]
[]  []  [][]    [][]  []      []  [][]  []          []  []    [][]      [][]                []      []  []        []  []  []  []  []  []  []  []        [][][]    []    []    []  []    []  []      []
[]      []    []    []    []          []  [][]  [][]        []    [][]    [][]  []  []  [][]    []    []    [][]      []          []  []  []    []  []  []    []    []      []    [][]  []    []  [][]
[]  [][]  []  [][]  []  []  [][]  [][]      []  []  []  []  []  []  []  []    []  [][]  []  []  [][]    []  []  []  []    [][]  []    []  []  []      [][][]  []  []  [][]    []    []      []      []
[]  [][]  []    []    []    []        [][]  []        []            []      []              [][]  [][]    []          []      []  []  []  []  []  []    []        []      []  []  []    []      []  []
[]            []    []  []  [][]  []  []    [][]  [][]  []  []  []      []    []  []  [][]              []  []  []  []  []  []        []        []  []  []  []  []    []      []  []  []  []  [][][][]
[]  []  [][]      []          [][]      []    []    []  []    []  [][]  []  []      []      []  [][][]            []          []  []    []  [][]          []    []  [][][][][]        []    []  []  []
[]  [][][]    []    [][]  []      [][]    []  []  []      [][]    []      [][][]  []    []    []    []  [][]  []    [][][]  []  []    [][]    []  []  []  [][]  []    []    []  []  []  []          []
[][]        []    []        []  []      []    []    [][]      []      []    [][][]  []  []  []  []      []  []  []      []  []    []        []  []  []              []  []    [][]  []      []  []  []
[]  []  [][]  []  []  []  []  []  [][]  [][]      []    [][]    [][]    [][]  []      []    []    []  []    []  []  [][]    []  []  []  []  []  []    []  []  [][][]        []          []    []  [][]
[]  [][][]    []  [][]    []  []  []      []  []    []    []  [][]    []      []  [][]  [][]  []  [][]  []  []          []  []            []      []    []        []  []  []  []  []  [][][]      [][]
[]        []            []    []      [][]  []    []  []          []  []  []      [][]  []              []    [][]  []  []      []  [][]  []  []  [][]    []  [][]      [][]        []  []  [][][]  []
[][][][]    [][]  [][]  [][]  []  []  []        []    [][]  []  []      []    [][]        [][]  [][]  []    []        []    []    []  []  []  []      []      []  [][]      []  []                  []
[]        []    []              []    []  [][]    []      []      []  []    []    []  [][]        [][]  []      [][]  []  [][]  [][]    []  []    []    [][]  []      []  []      [][]  []  [][]  [][]
[][][][]  [][]    [][]  [][]  []  []    []    []    []  []  [][]          []  []  []  [][][]  [][]        [][]  []  []        []    []  []    []    [][]        [][]  []      [][]    [][][][]  [][][]
[]            []  []  []      []    []  []  []    []    []    []  []  []  []      []    []    []  [][][]              []  [][][][]  []  [][]      []    [][]  []  []  []  [][][]    [][][]        [][]
[]  [][]  []            []  []  []      []    []  []  [][][]    []  []        []    []      [][]        [][]  []  []          []          []  []  []  [][]        []  []  []      []  []    [][][]  []
[][][][][]  []  [][][]            [][]    []  []        [][]  []        [][]    [][]    []      []  []  []  [][][]    []  [][]  []  []  []  []        []    []  [][]        []  []        []    []  []
[]  [][][]    []    []  [][][][]  []  []  []  [][]  []          []  []    []  []  []  []    [][]  []          []  []  []    []  []    []      []  []    []  [][][]    []  []        [][]  [][]      []
[]    []    []  []    []                            []  []  []  [][]    []  []      []  []    []    []  [][]  []    []  []  []    []    []  [][][][][]  []          []    [][]  []    [][]  []  []  []
[][]    []          []  [][]  []  [][][]  []  [][][]  []  []      [][]  []    []  []    []  [][][]    [][]    [][]  []  []  []  []  []        []  []      []  []  []    []        [][]  []        [][]
[]  []  []  [][][]      []  []  []      []  []        []    []  []  []      []      []        []  []  []  []                        []  []  []    [][]  [][]  []    []    []  []  []    []  [][][][][]
[]        []      []  [][]          []        []  []      [][]  []  []  []      [][]  [][]  []    []        [][]  [][][]  [][]  []  []    []    []  []          []  []  []    [][]  []            [][]
[]  []  []  [][]          []  [][][]  []  []    []    []              []  [][]        []      []    [][]  []    []    []  []  []  []    [][]  []        [][]  []  [][][]  []    []      [][]  []    []
[][]    []  []  [][]  [][][][][]  []    []  []    [][]  []  [][]  []  []  [][]  []  []  []  [][][]            []    []              []  []      []  []      [][]    []        []  []  []    []  [][][]
[]  []  []      [][]  []  []          []      []  []        []    []            []      []    []  []  [][][]    []      []  []  []  []    []  []      []  [][]    []  []  []              [][]      []
[]          []              [][]  []  [][]  []    [][][]  []  [][]  [][]  []  []  []  []    [][]    []    [][]  []  []  [][][][]  [][]  []      []  []  []      []          [][]  []  []  []    []  []
[]  []  [][]    [][][]  []  []  [][]          []      []  []  []        []    []    []  []  []    []  []    []    []        []            [][]            [][]  []  []  []      [][][]  []    []  [][]
[]  [][]      []        []      []  [][][][]  []  [][][][]    [][][]  []  []  []  []          []  []      []    [][]  []  []  []  [][]  []    [][]  []  []          [][]    [][]  []      []        []
[][]  [][]  []    []  []    []                        []  []          []  []  []    []  []  []      []  [][][]  []  []    []    []        []    []  [][]    []  []      []    []      [][]    []  [][]
[]      []  []  [][][]  []    []  []  [][]  []  []  []        []  []            []    []      [][]  []    []    []    []  []  [][]  []  []  []        []  []  []  [][][]  [][]  []  []    []    [][][]
[]  []      []  [][]    []  []  []  []    [][]    []    [][][][][]  [][][]  []      []  []  []  []      []  []  []  []    []  []    []  []  []  []  []                      []  []    []  [][]    [][]
[][]    []    []    []    []    []    []  []    []  [][]      []          []    []      []  []  [][]  []    []          []    [][]    [][]    []    []  [][]  []  [][]  [][]      []  []        []  []
[][][][]  []    []      []  []  [][]  []    []  []  [][][][]    [][]  []  [][]  []  []                  []    []  [][][]  []    []  []    []      []        []  [][][][]  []  [][]    []  [][]  []  []
[][]      []  []  [][]                  []            []    []      [][]    [][][][]  [][]  [][]  []  [][]  []    []  []    []      []  []  []  [][]  []  []      [][][]        []  [][]    [][]    []
[]  [][]    []        [][]  [][][]  []    []  []  []    []    []  []      []    []      []  []  []              [][]    []      [][]    []  []  []      []    [][]  []    []  []    []    []    []  []
[]        []  []  []  []  []      []  []  [][]  []  []  [][]        [][]  []  []  [][]    []    []  []  []  []      []    [][]    [][]            []  []  []          []    [][][]    []    []      []
[]  [][]      [][]        []  []                            [][]  [][]            [][]  [][]  [][]    []  []    []      []    []        [][][][][]            [][][]    []    []    [][]  []  []  [][]
[]      [][]      [][][]    []    []  [][]  [][][]  []  []        []  [][]  [][]              []    [][]    [][]    []    []  []  [][]  []          [][]  []      [][][]  []    []  []            [][]
[]  [][]      []          []    []  []    []    [][]      []  []  []  []  []      [][][]  []  []  []      []  []  []  []          []        []  []      []  []  []    []    []  []  [][]  [][][]    []
[][][]    []    []  [][]    [][]      []    []      [][]    [][]      []    [][][]    []    []  []  []  []      []      []  [][]  []  []  [][]  []  []  []    [][]  []  []            []  []  []  [][]
[]      [][][][]  []    []  []  [][]  []  [][][][]  []  [][]      []      [][]    []  []  [][]              [][]  [][]    []  []    []  []    [][][]  []  []        []      [][]  [][]          []  []
[]  []    []        []  []  []    []  []    []            [][]  [][]  [][]    []              [][][]  [][]    []  []  []          []    [][]  [][]        [][]  []  [][][]      []      []  []      []
[]  []  []  [][][]      []  [][]          []  []  [][]  []      []      []  []  [][]  []  [][]      [][]  []  []  []      []  []      []            [][][]        []    []  [][]  []  []  []  []  [][]
[][]  []          [][]            [][][]        []        []  []    []              []        [][]                [][][]    []    []  []  [][]  []          []  []    []    []    []      []    []  []
[]      []  [][]    [][]  [][][]  []      []  []  []  []    []  [][]  []  [][]  []      []  []    [][]  []  [][][]      []    []    []        []    [][]  []  []    []  []    []    []  []    [][]  []
[]  []    []      []    []      []    [][][]      [][]  []  []        [][]    [][]  []  []  []  []    []          []  []  []  []  []  []  [][]  [][]  [][][]      []    []  []    []      []  []    []
[]    [][]    []    []      [][]  []  []    []  []      []    [][][]      []  []  []  [][]  []    []    []  []  []          []              []              []  []    [][]    []  [][]  []        [][]
[]  []      []    []  [][]  []      []  []  []  [][][]    []          []                        []    [][]    []    [][]  []    [][][][]  [][]  [][]  []  [][]      []      []              []  []  []
[]    []  []  []                [][]                  []      [][]  []    []  []  []  []  [][]    []  []  []  [][]      [][][]          []          [][][]      []    [][]    []  [][]  [][]        []
[]  []  []        []  [][]  []        [][][][]  [][]      [][][]  [][]  []      []  []  []    []          []      []  []  []    []  [][]    []  [][]  []  [][]  []  []      [][]      []    []  []  []
[]          []  []  [][]  [][][]  [][]      [][]  []  [][][]              []  []        []  []  [][][][]    [][]  []        []    []      []  []      []  []      []    [][]      []    []    []    []
[][][][]  []    []          [][][]  [][][]          []        []  [][]  []  []    [][]  []              []          [][]  [][][]    []  []        [][]    []  []  []  []      [][]  []      []  []  []
[]      [][][][]    []  []    []            []  []      []  []      [][]        []        [][]  []  []    [][][][]    []    []    [][]      [][]  []    [][]  [][][]      []          []  []    []  []
[]  []    []    []  [][]  []      []  []  []  []    []    []    [][]  []  [][][]    [][]    []  [][][][]          []  []  [][][]  []    [][]    []  []  []            []    [][][]  [][]      []  [][]
[][]  []  []  [][][]      []  []  []  []        [][][]  [][][]    []    []      []  [][][]    []    []  [][]  []            []    []  []  [][]              []  []  []  [][]      [][]  []  [][]    []
[]            [][]  [][]        []      []  [][]          [][]  [][][]    []  []      [][][]    []  []        [][]  []  []    []                []  []  []    []              [][]        []      [][]
[]  [][]  []              [][][][][]  []    []    []  [][]      [][]  []      []  []    [][][]          []  []    []  []  []      []  []  []  []    [][]  []    []  [][]  []        [][]      []    []
[][]      []  []  [][][]        [][]  []  []  []  []  []    [][]          []    []  [][]  []  []  [][]    []  []  []        []  []  []  []  []  [][]  []    []    []  []  []  []  []    []  [][]  [][]
[]    []  []    []        []  []        []        []    []      []  []  [][][]                      []  []            [][]                                []    []          []        []    []      []
[][][][][][][][][][][][][][][][][][][][][][][][][][][][][][][][][][][][][][][][][][][][][][][][][][][][][][][][][][][][][][][]  [][][][][][][][][][][][][][][][][][][][][][][][][][][][][][][][][][][]